22 19

76 76 76 76 76 76 76 76 76 76 76 76 76 76 76 76 76 76 76 76 76 76 

76 06 02 06 63 64 64 64 64 65 10 02 10 02 02 02 00 06 05 06 02 76 

76 00 00 00 00 00 00 00 00 49 00 00 00 14 00 00 00 00 00 00 00 76 

76 00 00 00 00 00 00 00 00 49 00 00 05 11 12 00 05 05 04 05 00 76 

76 00 00 00 63 64 64 64 64 52 00 00 06 03 01 00 00 00 08 06 00 76 

76 00 00 00 00 00 00 00 00 00 00 00 00 01 00 00 00 00 04 03 00 76 

76 00 00 00 00 00 00 00 00 00 00 00 05 05 11 12 00 02 08 07 00 76 

76 00 00 00 00 00 00 06 00 00 00 00 00 00 00 00 00 00 02 01 02 76 

76 11 12 06 02 00 00 17 01 10 03 16 17 00 05 11 12 11 12 01 00 76 

76 05 05 09 10 00 00 00 17 18 07 19 20 10 09 08 06 18 06 11 12 76

76 00 00 11 12 02 00 00 00 00 00 01 02 17 17 01 09 01 16 17 18 76

76 00 00 04 09 01 00 00 00 00 00 01 02 01 01 00 13 01 02 13 14 76

76 00 00 08 05 00 00 02 00 00 00 06 05 01 00 00 00 00 01 13 14 76

76 00 00 00 00 00 00 00 00 00 00 00 01 00 00 00 00 00 03 02 09 76

76 00 00 00 00 00 00 00 00 00 00 00 38 00 00 00 00 00 07 10 02 76

76 00 00 00 00 00 00 00 00 00 00 00 00 00 00 00 00 00 00 02 10 76

76 05 05 10 04 00 00 00 26 27 02 43 44 44 44 44 44 44 44 45 04 76

76 02 01 02 08 00 00 22 23 24 06 06 11 12 13 00 11 12 06 06 08 76

76 76 76 76 76 76 76 76 76 76 76 76 76 76 76 76 76 76 76 76 76 76