40 20 

1  3 4 65  66  66  66  66  66  66 49 5 6 7 8 0 8 3 4 0 0 0 0 0 0 0 0 0 0 3 4 5 6 7 8 9 6 7 5 1 
0  0 0 0   0   0   0   0   0   0  54 0 0 0 3 0 0 0 0 0 0 0 0 0 0 0 0 0 0 0 0 0 0 0 0 0 3 4 0 0 
0  0 0 0   0   0   0   0   0   0  54  0 0 4 5 6 0 3 4 5 6 0 0 0 0 0 0 0 0 0 0 0 0 0 0 0 3 4 0 0 	
0  0 0 65 66  66  66  66  66  66  64  0 0 8 9 10 0 0 0 5 6 0 0 0 0 0 0 0 0 0 0 0 0 0 4 2 3 4 5 0  
0  0 0 0  0   0   0   0   0   0   0  0 0 0 9 0  0 0 0 5 6 0 0 0 0 0 0 0 0 0 0 0 0 0 0 0 3 4 5 0
0  0 0 0  0   0   0   0   0   0   0  0 0 8 9 13 14 0 4 5 6 0 0 0 0 0 0 0 0 0 0 27 28 29 0 0 3 13 14 15   
0  0 0 0  0   0   3   0   0   0   0  0  0  0 0 0 0  0  0 3  4  7 0 0 0  3  7  4 28 29 0 0  0  25 26 0  0  0  0  0  4   
13 14 7  15  0  0  3 20 3  5  18 17 0  3  4  13 14 3  13 14 3  0  5  15 15 15 3  5 25 26 13 14 20 20 20 20 20 25 26 20  
20 20 20 20  0  0  0  20 20 9  21 22 20 10 20 20 20 13 14 20 20 20 20 20 20 20 20 0 20 65 66 49 20 20 47 20 20 20 20 20
00 00 20 20  20 0  0  0  0  0  20 20 20 20 20 20 20 20 20 20 0  0  0  0  0  0  0  0  0  20 0  0  20 20 55 0  0  0  0  0 
00 00 20 20  20 0  0  0  0  0  20 20 20 20 20 0  20 20 20 20 0  0  0  0  00 0  0  0  0  20 0  0  20 20 55 0  0  0  0  0 
00 00 20 20  0  0  20 0  0  00 20 20 20 0  0  0  00 20 20 20 0  0  0  0  66 67 67 67 68 20 0  0  20 20 55 0  0  0  0  0 
00 00 00 00  0  0  00 0  0  00 00 20 00 0  0  0  00 20 20 20 0  0  0  0  00 00 00 00 00 00 00 66 67 67 61 0  0  0  0  0 
00 00 00 00  0  0  00 0  0  00 00 50 00 0  0  0  00 20 20 20 0  0  0  0  20 20 20 20 00 00 00 00 00 00 20 0  0  0  0  0 
00 00 00 00  0  0  00 0  0  0  00 00 00 0  0  0  00 00 20 20 0  0  0  20 00 00 20 20 00 00 00 00 00 00 20 20 20 20 20 20 
20 20 20 20  0  0  00 20 20 20 65 66 66 66 66 66 66 66 67 20 20 20 20 20 00 20 20 20 20 20 20 20 20 20 20 20 20 20 20 20 
20 20 20 20  0  0  20 20 20 20 20 20 20 20 00 20 20 20 20 20 00 00 00 00 00  20 20 20 65 48 66 66 66 66 66 66 66 66 67 
00 00 00 00  0  0  00 00 00 00 00 00 20 20 00 00 00 00 00 00 00 00 00 00 00 00 20 20 20 20 54 00 00 00 00 00 00 00  67
